






                                         M
        M             M              XXXXXXXXXX
 XX    XXX            XX
MXX P                         XXXXXX
XXXXX                    XX          MXXXXX     M
 XX                                 XXX       XXXXX
 X                 XXXXXX
               M  XXXXXXXX
  M XXXXXXXXXXXXXXXXXXXXXX  M            XX    M
XXXXXXXXXXXXXXXXXXXXXXXXXXXXXXXXXXXXXXXXXXXXXXXXXXX
XXXXXXXXXXXXXXXXXXXXXXXXXXXXXXXXXXXXXXXXXXXXXXXXXXX
XXXXXXXXXXXXXXXXXXXXXXXXXXXXXXXXXXXXXXXXXXXXXXXXXXX
XXXXXXXXXXXXXXXXXXXXXXXXXXXXXXXXXXXXXXXXXXXXXXXXXXX
XXXXXXXXXXXXXXXXXXXXXXXXXXXXXXXXXXXXXXXXXXXXXXXXXXX