






                                         M
        M             M              XXXXXXXXXX
 XX    XXX            XX
MXX P                         XXXXXX    E
XXXXX                    XX          MXXXXX     M
 XX                                 XXX       XXXXX
 X                 XXXXXX
       E       M  XXXXXXXX
  M XXXXXXXXXXXXXXXXXXXXXX  M    E       XX    M
XXXXXXXXXXXXXXXXXXXXXXXXXXXXXXXXXXXXXXXXXXXXXXXXXXX
XXXXXXXXXXXXXXXXXXXXXXXXXXXXXXXXXXXXXXXXXXXXXXXXXXX
XXXXXXXXXXXXXXXXXXXXXXXXXXXXXXXXXXXXXXXXXXXXXXXXXXX
XXXXXXXXXXXXXXXXXXXXXXXXXXXXXXXXXXXXXXXXXXXXXXXXXXX
XXXXXXXXXXXXXXXXXXXXXXXXXXXXXXXXXXXXXXXXXXXXXXXXXXX